##########
#...#....#
#....#.>.#
#..#...#.#
##########
2 1 1.5
1 8 2.0
3 2 1.2
